{
    "name": "Level Final",
    "positions": [
        [0, 0, 0, 1, 2, 1, 0, 0, 0, 0, 0, 0, 1, 2, 1, 0, 0, 0],
        [0, 0, 1, 2, 4, 2, 1, 0, 0, 0, 0, 1, 2, 4, 2, 1, 0, 0],
        [0, 2, 3, 4, 5, 4, 3, 2, 0, 0, 2, 3, 4, 5, 4, 3, 2, 0],
        [0, 2, 3, 5, 5, 5, 3, 2, 0, 0, 2, 3, 5, 5, 5, 3, 2, 0],
        [0, 2, 3, 4, 5, 4, 3, 2, 0, 0, 2, 3, 4, 5, 4, 3, 2, 0],
        [0, 0, 1, 2, 4, 2, 1, 0, 0, 0, 0, 1, 2, 4, 2, 1, 0, 0],
        [0, 0, 0, 1, 2, 1, 0, 0, 0, 0, 0, 0, 1, 2, 1, 0, 0, 0],
        [1, 0, 0, 0, 0, 0, 0, 0, 1, 1, 0, 0, 0, 0, 0, 0, 0, 1],
        [2, 1, 0, 0, 0, 0, 0, 1, 2, 2, 1, 0, 0, 0, 0, 0, 1, 2]
    ]
}