{
    "name": "Level Final",
    "positions": [
        [0, 0, 0, 0, 0, 0, 0, 0, 0, 0, 0, 0, 0, 0, 0, 0, 0, 0, 0],
        [0, 0, 0, 5, 5, 5, 0, 0, 0, 0, 0, 0, 4, 4, 4, 4, 4, 0, 0],
        [0, 0, 5, 5, 5, 3, 5, 0, 0, 0, 0, 4, 1, 1, 1, 1, 1, 4, 0],
        [0, 5, 5, 5, 5, 5, 0, 0, 0, 0, 0, 4, 1, 3, 1, 3, 1, 4, 0],
        [0, 5, 5, 5, 5, 0, 0, 0, 0, 0, 0, 4, 1, 3, 1, 3, 1, 4, 0],
        [0, 5, 5, 5, 5, 5, 0, 0, 0, 0, 0, 4, 1, 1, 1, 1, 1, 4, 0],
        [0, 0, 5, 5, 5, 5, 5, 0, 0, 0, 0, 4, 1, 1, 1, 1, 1, 4, 0],
        [0, 0, 0, 5, 5, 5, 0, 0, 0, 0, 0, 4, 4, 1, 4, 1, 4, 4, 0],
        [0, 0, 0, 0, 0, 0, 0, 0, 0, 0, 0, 4, 0, 4, 0, 4, 0, 4, 0],
        [0, 0, 0, 0, 0, 0, 0, 0, 0, 0, 0, 4, 0, 4, 0, 4, 0, 4, 0]
    ]
}