{
    "name": "Main Level",
    "positions": [
        [0, 1, 3, 2, 2, 2, 3, 1, 0, 0, 1, 3, 2, 2, 2, 3, 1, 0],
        [0, 0, 1, 3, 4, 3, 1, 0, 0, 0, 0, 1, 3, 4, 3, 1, 0, 0],
        [0, 0, 0, 1, 5, 1, 0, 0, 0, 0, 0, 0, 1, 5, 1, 0, 0, 0],
        [0, 0, 4, 5, 4, 5, 4, 0, 0, 0, 0, 4, 5, 4, 5, 4, 0, 0],
        [0, 0, 0, 1, 5, 1, 0, 0, 0, 0, 0, 0, 1, 5, 1, 0, 0, 0],
        [1, 0, 0, 0, 4, 0, 0, 0, 0, 0, 0, 0, 0, 4, 0, 0, 0, 1],
        [2, 1, 0, 0, 0, 0, 0, 1, 2, 2, 1, 0, 0, 0, 0, 0, 1, 2],
        [3, 2, 1, 0, 0, 0, 1, 2, 3, 3, 2, 1, 0, 0, 0, 1, 2, 3],
        [2, 1, 0, 0, 0, 0, 0, 1, 2, 2, 1, 0, 0, 0, 0, 0, 1, 2],
        [1, 0, 0, 0, 0, 0, 0, 0, 0, 0, 0, 0, 0, 0, 0, 0, 0, 1]
    ]
}